###########################
# ...........##...........#
#.####.#####.##.#####.###.#
#.####.#####.##.#####.###.#
#.####.#####.##.#####.###.#
#.........................#
#.####.##.########.##.###.#
#......##.########.##.....#
######.##....##....##.#####
######.#####.##.#####.#####
######.#####.##.#####.#####
######.##..........##.#####
######.##..........##.#####
#.........#.#..##.........#
######.##.#.....#..##.#####
######.##.#..#..#..##.#####
######.##.#..#..#..##.#####
######.##.#.....#..##.#####
######.##.#######..##.#####
#.........................#
#.####.#####.#.#####.####.#
#.####.#####.#.#####.####.#
#...##.......#.......##...#
###.##.##.........##.##.###
###.##.##.#######.##.##...#
#......##....#....##......#
#.##########.#.##########.#
#.##########.#.##########.#
#.........................#
###########################